../assets/image_assets/Tiles.png
1,1 2,1 2,1 2,1 2,1 2,1 2,1 2,1 2,1 2,1 2,1 2,1 2,1 2,1 2,1 2,1 2,1 2,1 2,1 2,1 2,1 2,1 2,1 2,1 2,1 2,1 2,1 2,1 2,1 2,1 2,1 2,1 2,1 2,1 2,1 2,1 2,1 2,1 2,1 2,1 2,1 2,1 2,1 2,1 3,1
4,1 8,0 8,0 8,0 8,0 8,0 8,0 8,0 9,1 5,0 5,0 5,0 5,0 9,1 5,0 5,0 5,0 5,0 9,1 5,0 5,0 5,0 5,0 9,1 5,0 5,0 5,0 5,0 9,1 5,0 5,0 5,0 5,0 9,1 3,0 3,0 3,0 9,1 7,0 7,0 7,0 7,0 7,0 7,0 5,1
4,1 8,0 8,0 8,0 8,0 8,0 8,0 8,0 9,1 5,0 5,0 5,0 5,0 9,1 5,0 5,0 5,0 5,0 9,1 5,0 5,0 5,0 5,0 9,1 5,0 5,0 5,0 5,0 9,1 5,0 5,0 5,0 5,0 9,1 3,0 3,0 3,0 9,1 7,0 7,0 7,0 7,0 7,0 7,0 5,1
4,1 8,0 8,0 8,0 8,0 8,0 8,0 8,0 9,1 5,0 5,0 5,0 5,0 9,1 5,0 5,0 5,0 5,0 9,1 5,0 5,0 5,0 5,0 9,1 5,0 5,0 5,0 5,0 9,1 5,0 5,0 5,0 5,0 9,1 3,0 3,0 3,0 9,1 7,0 7,0 7,0 7,0 7,0 7,0 5,1
4,1 8,0 8,0 8,0 8,0 8,0 8,0 8,0 9,1 5,0 5,0 5,0 5,0 9,1 5,0 5,0 5,0 5,0 9,1 5,0 5,0 5,0 5,0 9,1 5,0 5,0 5,0 5,0 9,1 5,0 5,0 5,0 5,0 9,1 3,0 3,0 3,0 9,1 7,0 7,0 7,0 7,0 7,0 7,0 5,1
4,1 8,0 8,0 8,0 8,0 8,0 8,0 8,0 9,1 5,0 5,0 5,0 5,0 9,1 5,0 5,0 5,0 5,0 9,1 5,0 5,0 5,0 5,0 9,1 5,0 5,0 5,0 5,0 9,1 5,0 5,0 5,0 5,0 9,1 3,0 3,0 3,0 7,0 7,0 7,0 7,0 7,0 7,0 7,0 5,1
4,1 8,0 8,0 8,0 8,0 8,0 8,0 8,0 4,2 9,2 9,2 5,0 9,2 2,2 9,2 9,2 5,0 9,2 2,2 9,2 9,2 5,0 9,2 2,2 9,2 9,2 5,0 9,2 2,2 9,2 9,2 5,0 9,2 3,2 3,0 3,0 3,0 9,1 7,0 7,0 7,0 7,0 7,0 7,0 5,1
4,1 8,0 8,0 8,0 8,0 8,0 8,0 8,0 9,1 1,0 1,0 1,0 1,0 1,0 1,0 1,0 1,0 1,0 1,0 1,0 1,0 1,0 1,0 1,0 1,0 1,0 1,0 1,0 1,0 1,0 1,0 1,0 1,0 9,1 3,0 3,0 3,0 4,2 9,2 9,2 9,2 9,2 9,2 9,2 5,1
4,1 8,0 8,0 8,0 8,0 8,0 8,0 8,0 9,1 1,0 1,0 1,0 1,0 1,0 1,0 1,0 1,0 1,0 1,0 1,0 1,0 1,0 1,0 1,0 1,0 1,0 1,0 1,0 1,0 1,0 1,0 1,0 1,0 9,1 3,0 3,0 3,0 9,1 7,0 7,0 7,0 7,0 7,0 7,0 5,1
4,1 8,0 8,0 8,0 8,0 8,0 8,0 8,0 9,1 1,0 1,0 1,0 1,0 1,0 1,0 1,0 1,0 1,0 1,0 1,0 1,0 1,0 1,0 1,0 1,0 1,0 1,0 1,0 1,0 1,0 1,0 1,0 1,0 9,1 3,0 3,0 3,0 9,1 7,0 7,0 7,0 7,0 7,0 7,0 5,1
4,1 8,0 8,0 8,0 8,0 8,0 8,0 8,0 1,0 1,0 1,0 1,0 1,0 1,0 1,0 1,0 1,0 1,0 1,0 1,0 1,0 1,0 1,0 1,0 1,0 1,0 1,0 1,0 1,0 1,0 1,0 1,0 1,0 9,1 3,0 3,0 3,0 9,1 7,0 7,0 7,0 7,0 7,0 7,0 5,1
4,1 8,0 8,0 8,0 8,0 8,0 8,0 8,0 9,1 1,0 1,0 1,0 1,0 1,0 1,0 1,0 1,0 1,0 1,0 1,0 1,0 1,0 1,0 1,0 1,0 1,0 1,0 1,0 1,0 1,0 1,0 1,0 1,0 9,1 3,0 3,0 3,0 9,1 7,0 7,0 7,0 7,0 7,0 7,0 5,1
4,1 8,0 8,0 8,0 8,0 8,0 8,0 8,0 9,1 1,0 1,0 1,0 1,0 1,0 1,0 1,0 1,0 1,0 1,0 1,0 1,0 1,0 1,0 1,0 1,0 1,0 1,0 1,0 1,0 1,0 1,0 1,0 1,0 9,1 3,0 3,0 3,0 7,0 7,0 7,0 7,0 7,0 7,0 7,0 5,1
4,1 8,0 8,0 8,0 8,0 8,0 8,0 8,0 9,1 1,0 1,0 1,0 1,0 1,0 1,0 1,0 1,0 1,0 1,0 1,0 1,0 1,0 1,0 1,0 1,0 1,0 1,0 1,0 1,0 1,0 1,0 1,0 1,0 9,1 3,0 3,0 3,0 9,1 7,0 7,0 7,0 7,0 7,0 7,0 5,1
4,1 8,0 8,0 8,0 8,0 8,0 8,0 8,0 9,1 1,0 1,0 1,0 1,0 1,0 1,0 1,0 1,0 1,0 1,0 1,0 1,0 1,0 1,0 1,0 1,0 1,0 1,0 1,0 1,0 1,0 1,0 1,0 1,0 9,1 3,0 3,0 3,0 4,2 9,2 9,2 9,2 9,2 9,2 9,2 5,1
4,1 8,0 8,0 8,0 8,0 8,0 8,0 8,0 9,1 1,0 1,0 1,0 1,0 1,0 1,0 1,0 1,0 1,0 1,0 1,0 1,0 1,0 1,0 1,0 1,0 1,0 1,0 1,0 1,0 1,0 1,0 1,0 1,0 9,1 3,0 3,0 3,0 9,1 9,0 9,0 9,0 9,0 9,0 9,0 5,1
4,1 8,0 8,0 8,0 8,0 8,0 8,0 8,0 9,1 1,0 1,0 1,0 1,0 1,0 1,0 1,0 1,0 1,0 1,0 1,0 1,0 1,0 1,0 1,0 1,0 1,0 1,0 1,0 1,0 1,0 1,0 1,0 1,0 9,1 3,0 3,0 3,0 9,1 9,0 9,0 9,0 9,0 9,0 9,0 5,1
4,1 8,0 8,0 8,0 8,0 8,0 8,0 8,0 9,1 1,0 1,0 1,0 1,0 1,0 1,0 1,0 1,0 1,0 1,0 1,0 1,0 1,0 1,0 1,0 1,0 1,0 1,0 1,0 1,0 1,0 1,0 1,0 1,0 1,0 3,0 3,0 3,0 9,1 9,0 9,0 9,0 9,0 9,0 9,0 5,1
4,1 8,0 8,0 8,0 8,0 8,0 8,0 8,0 9,1 1,0 1,0 1,0 1,0 1,0 1,0 1,0 1,0 1,0 1,0 1,0 1,0 1,0 1,0 1,0 1,0 1,0 1,0 1,0 1,0 1,0 1,0 1,0 1,0 9,1 3,0 3,0 3,0 9,1 9,0 9,0 9,0 9,0 9,0 9,0 5,1
4,1 8,0 8,0 8,0 8,0 8,0 8,0 8,0 9,1 1,0 1,0 1,0 1,0 1,0 1,0 1,0 1,0 1,0 1,0 1,0 1,0 1,0 1,0 1,0 1,0 1,0 1,0 1,0 1,0 1,0 1,0 1,0 1,0 9,1 3,0 3,0 3,0 9,1 9,0 9,0 9,0 9,0 9,0 9,0 5,1
4,1 9,2 9,2 9,2 9,2 9,2 9,2 9,2 2,2 9,2 9,2 9,2 9,2 9,2 9,2 9,2 9,2 9,2 9,2 9,2 9,2 9,2 9,2 9,2 9,2 9,2 9,2 9,2 9,2 9,2 9,2 9,2 9,2 8,2 3,0 3,0 3,0 9,0 9,0 9,0 9,0 9,0 9,0 9,0 5,1
4,1 3,0 3,0 3,0 3,0 3,0 3,0 3,0 3,0 3,0 3,0 3,0 3,0 3,0 3,0 3,0 3,0 3,0 3,0 3,0 3,0 3,0 3,0 3,0 3,0 3,0 3,0 3,0 3,0 3,0 3,0 3,0 3,0 3,0 3,0 3,0 3,0 9,1 9,0 9,0 9,0 9,0 9,0 9,0 5,1
4,1 3,0 3,0 3,0 3,0 3,0 3,0 3,0 3,0 3,0 3,0 3,0 3,0 3,0 3,0 3,0 3,0 3,0 3,0 3,0 3,0 3,0 3,0 3,0 3,0 3,0 3,0 3,0 3,0 3,0 3,0 3,0 3,0 3,0 3,0 3,0 3,0 9,1 9,0 9,0 9,0 9,0 9,0 9,0 5,1
4,1 3,0 3,0 3,0 3,0 3,0 3,0 3,0 3,0 3,0 3,0 3,0 3,0 3,0 3,0 3,0 3,0 3,0 3,0 3,0 3,0 3,0 3,0 3,0 3,0 3,0 3,0 3,0 3,0 3,0 3,0 3,0 3,0 3,0 3,0 3,0 3,0 9,1 9,0 9,0 9,0 9,0 9,0 9,0 5,1
4,1 9,2 6,0 9,2 9,2 9,2 9,2 9,2 9,2 9,2 9,2 9,2 9,2 6,0 9,2 1,2 9,2 9,2 5,0 9,2 9,2 5,2 3,0 3,0 3,0 6,2 9,2 9,2 9,2 9,2 9,2 9,2 9,2 9,2 9,2 9,2 9,2 2,2 9,2 9,2 9,2 9,2 9,2 9,2 5,1
4,1 6,0 6,0 6,0 6,0 6,0 6,0 6,0 6,0 6,0 6,0 6,0 6,0 6,0 6,0 9,1 5,0 5,0 5,0 5,0 5,0 9,1 3,0 3,0 3,0 9,1 1,0 1,0 1,0 1,0 1,0 1,0 1,0 1,0 1,0 1,0 1,0 1,0 1,0 1,0 1,0 1,0 1,0 1,0 5,1
4,1 6,0 6,0 6,0 6,0 6,0 6,0 6,0 6,0 6,0 6,0 6,0 6,0 6,0 6,0 9,1 5,0 5,0 5,0 5,0 5,0 9,1 3,0 3,0 3,0 9,1 1,0 1,0 1,0 1,0 1,0 1,0 1,0 1,0 1,0 1,0 1,0 1,0 1,0 1,0 1,0 1,0 1,0 1,0 5,1
4,1 6,0 6,0 6,0 6,0 6,0 6,0 6,0 6,0 6,0 6,0 6,0 6,0 6,0 6,0 9,1 5,0 5,0 5,0 5,0 5,0 9,1 3,0 3,0 3,0 9,1 1,0 1,0 1,0 1,0 1,0 1,0 1,0 1,0 1,0 1,0 1,0 1,0 1,0 1,0 1,0 1,0 1,0 1,0 5,1
4,1 6,0 6,0 6,0 6,0 6,0 6,0 6,0 6,0 6,0 6,0 6,0 6,0 6,0 6,0 9,1 5,0 5,0 5,0 5,0 5,0 9,1 3,0 3,0 3,0 9,1 1,0 1,0 1,0 1,0 1,0 1,0 1,0 1,0 1,0 1,0 1,0 1,0 1,0 1,0 1,0 1,0 1,0 1,0 5,1
4,1 6,0 6,0 6,0 6,0 6,0 6,0 6,0 6,0 6,0 6,0 6,0 6,0 6,0 6,0 4,2 9,2 9,2 9,2 9,2 9,2 3,2 3,0 3,0 3,0 9,1 1,0 1,0 1,0 1,0 1,0 1,0 1,0 1,0 1,0 1,0 1,0 1,0 1,0 1,0 1,0 1,0 1,0 1,0 5,1
4,1 6,0 6,0 6,0 6,0 6,0 6,0 6,0 6,0 6,0 6,0 6,0 6,0 6,0 6,0 9,1 5,0 5,0 5,0 5,0 5,0 9,1 3,0 3,0 3,0 9,1 1,0 1,0 1,0 1,0 1,0 1,0 1,0 1,0 1,0 1,0 1,0 1,0 1,0 1,0 1,0 1,0 1,0 1,0 5,1
4,1 6,0 6,0 6,0 6,0 6,0 6,0 6,0 6,0 6,0 6,0 6,0 6,0 6,0 6,0 9,1 5,0 5,0 5,0 5,0 5,0 9,1 3,0 3,0 3,0 9,1 1,0 1,0 1,0 1,0 1,0 1,0 1,0 1,0 1,0 1,0 1,0 1,0 1,0 1,0 1,0 1,0 1,0 1,0 5,1
4,1 6,0 6,0 6,0 6,0 6,0 6,0 6,0 6,0 6,0 6,0 6,0 6,0 6,0 6,0 9,1 5,0 5,0 5,0 5,0 5,0 9,1 3,0 3,0 3,0 9,1 1,0 1,0 1,0 1,0 1,0 1,0 1,0 1,0 1,0 1,0 1,0 1,0 1,0 1,0 1,0 1,0 1,0 1,0 5,1
4,1 6,0 6,0 6,0 6,0 6,0 6,0 6,0 6,0 6,0 6,0 6,0 6,0 6,0 6,0 9,1 5,0 5,0 5,0 5,0 5,0 9,1 3,0 3,0 3,0 9,1 1,0 1,0 1,0 1,0 1,0 1,0 1,0 1,0 1,0 1,0 1,0 1,0 1,0 1,0 1,0 1,0 1,0 1,0 5,1
4,1 9,2 6,0 9,2 9,2 9,2 9,2 9,2 9,2 9,2 9,2 9,2 9,2 9,2 9,2 2,2 9,2 9,2 5,0 9,2 9,2 8,2 3,0 3,0 3,0 7,2 9,2 1,0 9,2 9,2 9,2 9,2 9,2 9,2 9,2 9,2 9,2 9,2 9,2 9,2 9,2 9,2 9,2 9,2 5,1
4,1 3,0 3,0 3,0 3,0 3,0 3,0 3,0 3,0 3,0 3,0 3,0 3,0 3,0 3,0 3,0 3,0 3,0 3,0 3,0 3,0 3,0 3,0 3,0 3,0 3,0 3,0 3,0 3,0 3,0 3,0 3,0 3,0 3,0 3,0 3,0 3,0 3,0 3,0 3,0 3,0 3,0 3,0 3,0 5,1
4,1 3,0 3,0 3,0 3,0 3,0 3,0 3,0 3,0 3,0 3,0 3,0 3,0 3,0 3,0 3,0 3,0 3,0 3,0 3,0 3,0 3,0 3,0 3,0 3,0 3,0 3,0 3,0 3,0 3,0 3,0 3,0 3,0 3,0 3,0 3,0 3,0 3,0 3,0 3,0 3,0 3,0 3,0 3,0 5,1
4,1 3,0 3,0 3,0 3,0 3,0 3,0 3,0 3,0 3,0 3,0 3,0 3,0 3,0 3,0 3,0 3,0 3,0 3,0 3,0 3,0 3,0 3,0 3,0 3,0 3,0 3,0 3,0 3,0 3,0 3,0 3,0 3,0 3,0 3,0 3,0 3,0 3,0 3,0 3,0 3,0 3,0 3,0 3,0 5,1
4,1 9,2 3,0 9,2 9,2 9,2 9,2 9,2 9,2 9,2 9,2 9,2 9,2 9,2 9,2 9,2 9,2 9,2 9,2 9,2 9,2 5,2 3,0 3,0 3,0 6,2 9,2 3,0 9,2 9,2 9,2 9,2 9,2 9,2 9,2 9,2 9,2 9,2 9,2 9,2 9,2 9,2 9,2 9,2 5,1
4,1 0,0 0,0 0,0 0,0 0,0 0,0 0,0 0,0 0,0 0,0 0,0 0,0 0,0 0,0 0,0 0,0 0,0 0,0 0,0 0,0 9,1 3,0 3,0 3,0 9,1 3,0 3,0 3,0 3,0 3,0 3,0 3,0 3,0 3,0 3,0 3,0 3,0 3,0 3,0 3,0 3,0 3,0 3,0 5,1
4,1 0,0 0,0 0,0 0,0 0,0 0,0 0,0 0,0 0,0 0,0 0,0 0,0 0,0 0,0 0,0 0,0 0,0 0,0 0,0 0,0 9,1 3,0 3,0 3,0 9,1 3,0 3,0 3,0 3,0 3,0 3,0 3,0 3,0 3,0 3,0 3,0 3,0 3,0 3,0 3,0 3,0 3,0 3,0 5,1
4,1 0,0 0,0 0,0 0,0 0,0 0,0 0,0 0,0 0,0 0,0 0,0 0,0 0,0 0,0 0,0 0,0 0,0 0,0 0,0 0,0 9,1 3,0 3,0 3,0 9,1 3,0 3,0 3,0 3,0 3,0 3,0 3,0 3,0 3,0 3,0 3,0 3,0 3,0 3,0 3,0 3,0 3,0 3,0 5,1
4,1 0,0 0,0 0,0 0,0 0,0 0,0 0,0 0,0 0,0 0,0 0,0 0,0 0,0 0,0 0,0 0,0 0,0 0,0 0,0 0,0 9,1 3,0 3,0 3,0 9,1 3,0 3,0 3,0 3,0 3,0 3,0 3,0 3,0 3,0 3,0 3,0 3,0 3,0 3,0 3,0 3,0 3,0 3,0 5,1
4,1 0,0 0,0 0,0 0,0 0,0 0,0 0,0 0,0 0,0 0,0 0,0 0,0 0,0 0,0 0,0 0,0 0,0 0,0 0,0 0,0 9,1 3,0 3,0 3,0 9,1 3,0 3,0 3,0 3,0 3,0 3,0 3,0 3,0 3,0 3,0 3,0 3,0 3,0 3,0 3,0 3,0 3,0 3,0 5,1
4,1 0,0 0,0 0,0 0,0 0,0 0,0 0,0 0,0 0,0 0,0 0,0 0,0 0,0 0,0 0,0 0,0 0,0 0,0 0,0 0,0 9,1 3,0 3,0 3,0 9,1 3,0 3,0 3,0 3,0 3,0 3,0 3,0 3,0 3,0 3,0 3,0 3,0 3,0 3,0 3,0 3,0 3,0 3,0 5,1
4,1 0,0 0,0 0,0 0,0 0,0 0,0 0,0 0,0 0,0 0,0 0,0 0,0 0,0 0,0 0,0 0,0 0,0 0,0 0,0 0,0 9,1 3,0 3,0 3,0 9,1 3,0 3,0 3,0 3,0 3,0 3,0 3,0 3,0 3,0 3,0 3,0 3,0 3,0 3,0 3,0 3,0 3,0 3,0 5,1
4,1 0,0 0,0 0,0 0,0 0,0 0,0 0,0 0,0 0,0 0,0 0,0 0,0 0,0 0,0 0,0 0,0 0,0 0,0 0,0 0,0 9,1 3,0 3,0 3,0 9,1 3,0 3,0 3,0 3,0 3,0 3,0 3,0 3,0 3,0 3,0 3,0 3,0 3,0 3,0 3,0 3,0 3,0 3,0 5,1
4,1 0,0 0,0 0,0 0,0 0,0 0,0 0,0 0,0 0,0 0,0 0,0 0,0 0,0 0,0 0,0 0,0 0,0 0,0 0,0 0,0 9,1 3,0 3,0 3,0 9,1 3,0 3,0 3,0 3,0 3,0 3,0 3,0 3,0 3,0 3,0 3,0 3,0 3,0 3,0 3,0 3,0 3,0 3,0 5,1
4,1 0,0 0,0 0,0 0,0 0,0 0,0 0,0 0,0 0,0 0,0 0,0 0,0 0,0 0,0 0,0 0,0 0,0 0,0 0,0 0,0 9,1 3,0 3,0 3,0 4,2 9,2 9,2 9,2 9,2 9,2 1,2 9,2 9,2 9,2 9,2 9,2 9,2 9,2 9,2 9,2 9,2 9,2 9,2 5,1
4,1 0,0 0,0 0,0 0,0 0,0 0,0 0,0 0,0 0,0 0,0 0,0 0,0 0,0 0,0 0,0 0,0 0,0 0,0 0,0 0,0 9,1 3,0 3,0 3,0 9,1 8,0 8,0 8,0 8,0 8,0 9,1 9,0 9,0 9,0 9,0 9,0 9,0 9,0 9,0 9,0 9,0 9,0 9,0 5,1
4,1 0,0 0,0 0,0 0,0 0,0 0,0 0,0 0,0 0,0 0,0 0,0 0,0 0,0 0,0 0,0 0,0 0,0 0,0 0,0 0,0 9,1 3,0 3,0 3,0 9,1 8,0 8,0 8,0 8,0 8,0 9,1 9,0 9,0 9,0 9,0 9,0 9,0 9,0 9,0 9,0 9,0 9,0 9,0 5,1
4,1 0,0 0,0 0,0 0,0 0,0 0,0 0,0 0,0 0,0 0,0 0,0 0,0 0,0 0,0 0,0 0,0 0,0 0,0 0,0 0,0 9,1 3,0 3,0 3,0 9,1 8,0 8,0 8,0 8,0 8,0 9,1 9,0 9,0 9,0 9,0 9,0 9,0 9,0 9,0 9,0 9,0 9,0 9,0 5,1
4,1 0,0 0,0 0,0 0,0 0,0 0,0 0,0 0,0 0,0 0,0 0,0 0,0 0,0 0,0 0,0 0,0 0,0 0,0 0,0 0,0 9,1 3,0 3,0 3,0 9,1 8,0 8,0 8,0 8,0 8,0 9,1 9,0 9,0 9,0 9,0 9,0 9,0 9,0 9,0 9,0 9,0 9,0 9,0 5,1
4,1 0,0 0,0 0,0 0,0 0,0 0,0 0,0 0,0 0,0 0,0 0,0 0,0 0,0 0,0 0,0 0,0 0,0 0,0 0,0 0,0 9,1 3,0 3,0 3,0 9,1 8,0 8,0 8,0 8,0 8,0 9,1 9,0 9,0 9,0 9,0 9,0 9,0 9,0 9,0 9,0 9,0 9,0 9,0 5,1
4,1 0,0 0,0 0,0 0,0 0,0 0,0 0,0 0,0 0,0 0,0 0,0 0,0 0,0 0,0 0,0 0,0 0,0 0,0 0,0 0,0 9,1 3,0 3,0 3,0 7,2 9,2 8,0 9,2 9,2 9,2 2,2 9,2 9,0 9,2 9,2 9,2 9,2 9,2 9,2 9,2 9,2 9,2 9,2 5,1
4,1 0,0 0,0 0,0 0,0 0,0 0,0 0,0 0,0 0,0 0,0 0,0 0,0 0,0 0,0 0,0 0,0 0,0 0,0 0,0 0,0 9,1 3,0 3,0 3,0 3,0 3,0 3,0 3,0 3,0 3,0 3,0 3,0 3,0 3,0 3,0 3,0 3,0 3,0 3,0 3,0 3,0 3,0 3,0 5,1
4,1 0,0 0,0 0,0 0,0 0,0 0,0 0,0 0,0 0,0 0,0 0,0 0,0 0,0 0,0 0,0 0,0 0,0 0,0 0,0 0,0 9,1 3,0 3,0 3,0 3,0 3,0 3,0 3,0 3,0 3,0 3,0 3,0 3,0 3,0 3,0 3,0 3,0 3,0 3,0 3,0 3,0 3,0 3,0 5,1
4,1 0,0 0,0 0,0 0,0 0,0 0,0 0,0 0,0 0,0 0,0 0,0 0,0 0,0 0,0 0,0 0,0 0,0 0,0 0,0 0,0 9,1 3,0 3,0 3,0 3,0 3,0 3,0 3,0 3,0 3,0 3,0 3,0 3,0 3,0 3,0 3,0 3,0 3,0 3,0 3,0 3,0 3,0 3,0 5,1
4,1 0,0 0,0 0,0 0,0 0,0 0,0 0,0 0,0 0,0 0,0 0,0 0,0 0,0 0,0 0,0 0,0 0,0 0,0 0,0 0,0 9,1 3,0 3,0 3,0 6,2 9,2 0,1 9,2 9,2 9,2 9,2 9,2 9,2 9,2 9,2 9,2 9,2 9,2 9,2 9,2 9,2 0,1 9,2 5,1
4,1 0,0 0,0 0,0 0,0 0,0 0,0 0,0 0,0 0,0 0,0 0,0 0,0 0,0 0,0 0,0 0,0 0,0 0,0 0,0 0,0 3,0 3,0 3,0 3,0 9,1 0,1 0,1 0,1 0,1 0,1 0,1 0,1 0,1 0,1 0,1 0,1 0,1 0,1 0,1 0,1 0,1 0,1 0,1 5,1
4,1 0,0 0,0 0,0 0,0 0,0 0,0 0,0 0,0 0,0 0,0 0,0 0,0 0,0 0,0 0,0 0,0 0,0 0,0 0,0 0,0 9,1 3,0 3,0 3,0 9,1 0,1 0,1 0,1 0,1 0,1 0,1 0,1 0,1 0,1 0,1 0,1 0,1 0,1 0,1 0,1 0,1 0,1 0,1 5,1
4,1 9,2 3,0 9,2 9,2 9,2 9,2 9,2 9,2 9,2 9,2 9,2 9,2 9,2 9,2 9,2 9,2 9,2 9,2 9,2 9,2 8,2 3,0 3,0 3,0 9,1 0,1 0,1 0,1 0,1 0,1 0,1 0,1 0,1 0,1 0,1 0,1 0,1 0,1 0,1 0,1 0,1 0,1 0,1 5,1
4,1 3,0 3,0 3,0 3,0 3,0 3,0 3,0 3,0 3,0 3,0 3,0 3,0 3,0 3,0 3,0 3,0 3,0 3,0 3,0 3,0 3,0 3,0 3,0 3,0 9,1 0,1 0,1 0,1 0,1 0,1 0,1 0,1 0,1 0,1 0,1 0,1 0,1 0,1 0,1 0,1 0,1 0,1 0,1 5,1
4,1 3,0 3,0 3,0 3,0 3,0 3,0 3,0 3,0 3,0 3,0 3,0 3,0 3,0 3,0 3,0 3,0 3,0 3,0 3,0 3,0 3,0 3,0 3,0 3,0 9,1 0,1 0,1 0,1 0,1 0,1 0,1 0,1 0,1 0,1 0,1 0,1 0,1 0,1 0,1 0,1 0,1 0,1 0,1 5,1
4,1 3,0 3,0 3,0 3,0 3,0 3,0 3,0 3,0 3,0 3,0 3,0 3,0 3,0 3,0 3,0 3,0 3,0 3,0 3,0 3,0 3,0 3,0 3,0 3,0 9,1 0,1 0,1 0,1 0,1 0,1 0,1 0,1 0,1 0,1 0,1 0,1 0,1 0,1 0,1 0,1 0,1 0,1 0,1 5,1
4,1 9,2 5,0 9,2 1,2 9,2 5,0 9,2 1,2 9,2 5,0 9,2 1,2 9,2 5,0 9,2 1,2 9,2 5,0 9,2 1,2 9,2 5,0 9,2 1,2 8,2 0,1 0,1 0,1 0,1 0,1 0,1 0,1 0,1 0,1 0,1 0,1 0,1 0,1 0,1 0,1 0,1 0,1 0,1 5,1
4,1 5,0 5,0 5,0 9,1 5,0 5,0 5,0 9,1 5,0 5,0 5,0 9,1 5,0 5,0 5,0 9,1 5,0 5,0 5,0 9,1 5,0 5,0 5,0 9,1 0,1 0,1 0,1 0,1 0,1 0,1 0,1 0,1 0,1 0,1 0,1 0,1 0,1 0,1 0,1 0,1 0,1 0,1 0,1 5,1
4,1 5,0 5,0 5,0 9,1 5,0 5,0 5,0 9,1 5,0 5,0 5,0 9,1 5,0 5,0 5,0 9,1 5,0 5,0 5,0 9,1 5,0 5,0 5,0 9,1 0,1 0,1 0,1 0,1 0,1 0,1 0,1 0,1 0,1 0,1 0,1 0,1 0,1 0,1 0,1 0,1 0,1 0,1 0,1 5,1
4,1 5,0 5,0 5,0 9,1 5,0 5,0 5,0 9,1 5,0 5,0 5,0 9,1 5,0 5,0 5,0 9,1 5,0 5,0 5,0 9,1 5,0 5,0 5,0 9,1 0,1 0,1 0,1 0,1 0,1 0,1 0,1 0,1 0,1 0,1 0,1 0,1 0,1 0,1 0,1 0,1 0,1 0,1 0,1 5,1
6,1 7,1 7,1 7,1 7,1 7,1 7,1 7,1 7,1 7,1 7,1 7,1 7,1 7,1 7,1 7,1 7,1 7,1 7,1 7,1 7,1 7,1 7,1 7,1 7,1 7,1 7,1 7,1 7,1 7,1 7,1 7,1 7,1 7,1 7,1 7,1 7,1 7,1 7,1 7,1 7,1 7,1 7,1 7,1 8,1